Страна/регион
AC	Остров Вознесения
AD	Андорра
AE	Объединенные Арабские Эмираты
AG	Антигуа и Барбуда
AI	Ангилья
AL	Албания
AM	Армения
AO	Ангола
AQ	Антарктида
AR	Аргентина
AS	Американское Самоа
AT	Австрия
AU	Австралия
AW	Аруба
AX	Аландские острова
AZ	Азербайджан
BA	Босния и Герцеговина
BB	Барбадос
BD	Бангладеш
BE	Бельгия
BF	Буркина-Фасо
BG	Болгария
BH	Бахрейн
BI	Бурунди
BJ	Бенин
BL	Сен-Бартелеми
BM	Бермуды
BN	Бруней
BO	Боливия
BQ	Бонэйр, Синт-Эстатиус и Саба
BR	Бразилия
BS	Багамы
BT	Бутан
BV	Остров Буве
BW	Ботсвана
BY	Беларусь
BZ	Белиз
CA	Канада
CC	Кокосовыe острова (острова Килинг)
CD	Конго (ДРК)
CF	Центрально-Африканская Республика
CG	Конго (Республика)
CH	Швейцария
CI	Кот-д’Ивуар
CK	Острова Кука
CL	Чили
CM	Камерун
CO	Колумбия
CR	Коста-Рика
CV	Кабо-Верде
CW	Кюрасао
CX	Остров Рождества
CY	Кипр
CZ	Чехия
DE	Германия
DJ	Джибути
DK	Дания
DM	Доминика
DO	Доминиканская Республика
DZ	Алжир
EC	Эквадор
EE	Эстония
EG	Египет
EH	Западная Сахара
ER	Эритрея
ES	Испания
ET	Эфиопия
FI	Финляндия
FJ	Фиджи
FK	Фолклендские острова (Мальвинские острова)
FM	Микронезия
FO	Фарерские острова
FR	Франция
GA	Габон
GB	Великобритания
GD	Гренада
GE	Грузия
GF	Французская Гвиана
GG	Гернси
GH	Гана
GI	Гибралтар
GL	Гренландия
GM	Гамбия
GN	Гвинея
GP	Гваделупа
GQ	Экваториальная Гвинея
GR	Греция
GS	Остров Южная Георгия и Южные Сандвичевы острова
GT	Гватемала
GU	Гуам
GW	Гвинея-Биссау
GY	Гайана
HK	Гонконг
HM	Остров Херд и острова Макдональд
HN	Гондурас
HR	Хорватия
HT	Гаити
HU	Венгрия
ID	Индонезия
IE	Ирландия
IL	Израиль
IM	Остров Мэн
IN	Индия
IO	Британская территория в Индийском океане
IQ	Ирак
IS	Исландия
IT	Италия
JE	Джерси
JM	Ямайка
JO	Иордания
JP	Япония
KE	Кения
KG	Киргизия
KH	Камбоджа
KI	Кирибати
KM	Коморские Острова
KN	Сент-Китс и Невис
KR	Южная Корея
KW	Кувейт
KY	Каймановы острова
KZ	Казахстан
LA	Лаос
LB	Ливан
LC	Сент-Люсия
LI	Лихтенштейн
LK	Шри-Ланка
LR	Либерия
LS	Лесото
LT	Литва
LU	Люксембург
LV	Латвия
LY	Ливия
MA	Марокко
MC	Монако
MD	Молдова
ME	Черногория
MF	Сен-Мартен
MG	Мадагаскар
MH	Маршалловы Острова
MK	Македония
ML	Мали
ММ	Мьянма (Бирма)
MN	Монголия
MO	Макао
MP	Северные Марианские острова
MQ	Мартиника
MR	Мавритания
MS	Монтсеррат
MT	Мальта
MU	Маврикий
MV	Мальдивы
MW	Малави
MX	Мексика
MY	Малайзия
MZ	Мозамбик
NA	Намибия
NC	Новая Каледония
NE	Нигер
NF	Остров Норфолк
NG	Нигерия
NI	Никарагуа
NL	Нидерланды
NO	Норвегия
NP	Непал
NR	Науру
NU	Ниуэ
NZ	Новая Зеландия
OM	Оман
PA	Панама
PE	Перу
PF	Французская Полинезия
PG	Папуа – Новая Гвинея
PH	Филиппины
PK	Пакистан
PL	Польша
PM	Сент-Пьер и Микелон
PN	Питкерн
PR	Пуэрто-Рико
PS	Палестина
PT	Португалия
PW	Палау
PY	Парагвай
QA	Катар
RE	Реюньон
RO	Румыния
RS	Сербия
RU	Россия
RW	Руанда
SA	Саудовская Аравия
SB	Соломоновы Острова
SC	Сейшельские Острова
SE	Швеция
SG	Сингапур
SH	Остров Святой Елены
SI	Словения
SJ	Шпицберген и Ян-Майен
SK	Словакия
SL	Сьерра-Леоне
SM	Сан-Марино
SN	Сенегал
SO	Сомали
SR	Суринам
SS	Южный Судан
ST	Сан-Томе и Принсипи
SV	Сальвадор
SX	Синт-Мартен
SZ	Свазиленд
TA	Тристан-да-Кунья
TC	Тёркс и Кайкос
TD	Чад
TF	Французские Южные территории
TG	Того
TH	Таиланд
TJ	Таджикистан
TK	Токелау
TL	Восточный Тимор
TM	Туркменистан
TN	Тунис
TO	Тонга
TR	Турция
TT	Тринидад и Тобаго
ТВ	Тувалу
TW	Тайвань
TZ	Танзания
UA	Украина
UG	Уганда
UM	Малые Тихоокеанские Отдаленные острова США
US	США
UY	Уругвай
UZ	Узбекистан
VA	Ватикан
VC	Сент-Винсент и Гренадины
VE	Венесуэла
VG	Британские Виргинские острова
VI	Американские Виргинские острова
VN	Вьетнам
VU	Вануату
WF	Уоллис и Футуна
WS	Самоа
XK	Косово
YE	Йемен
YT	Майотта
ZA	ЮАР
ZM	Замбия
ZW	Зимбабве